{
    "metadata": {
        "scale": 10
    },
    "map": [
        "__________",
        "_rrrrrrr__",
        "__________",
        "__________",
        "___^^^____",
        "____^^^___",
        "____^^^___",
        "__________",
        "__________",
        "__________"
    ]

}